XXXXXXXXXXXXXXXXXXXXX
Xd           e a    X
X               h   X
X        c          X
X     a         e   X
X                  bX
X                   X
X         g         X
X          sssssssssX
X       d  sssssssssX
Xd  d     AsssssssssX
Xa         sssssssssX
X       a  sssssssssX
X      c           gX
Xa               ff X
X               b   X
X                h  X
X       d           X
Xf      f           X
X   f               X
XXXXXXXXXXXXXXXXXXXXX
